##################################################################################################################################
#                                                                        #                            #                          #
#                                                                        #                            #                          #
#                                                                        #                            #                          #
#                                                                        #                            #                          #
#                                                                        #                                                       #
#                                                                        #              #                                        #
####################                                                     #              #                                        #
#                                                                        #              #            ##########################  #
#                                                                        #              #                                        #
#                                                       ##################                                                       #
#                                                       #                                                                        #
#                                                       #                                                                        #
#                     ##########################        #                                                                        #
#                                                       #                                                                        #
#                                                       #                             #                                          #
#                                                       #                             #                      #                   #
#                                                       #                             #                                          #
# ###################                                   #                             #                                          #
#                                                       #                                                 ##                     #
#                                                       #                                               ##                       #
#                                                       #                                                 ##                     #
#                    #                                  #                                               ##                       #
#                    #                      #############                                             ##                         #
#                    #                                                                            ######                         #
#                    #                                                                                                           #
#                    #                       #                                                                                   #
#                                            #                                                                                   #
#                                            #             ##########################                                            #
#                                            #                                                                                   #
#                                            #                                                                                   #
#                                                                                          #                                     #
#                                    #                                                                                           #
# #############                   ####                                                                                           #
#                                    #                                                          #                                #
#                                    ######                                                    ###                               #
#                                    #                                                          #                                #
#                                                                                                                                #
#                                                                                                                                #
#                                              #                                 ##########                                      #
#                                              #                                                 #                               #
#                                              #                                                 #                               #
#################################          ########################################################      #########################
#                                                                                                                                #
#                                                                                                                                #
#                                                                                                                                #
#                                                                                                                                #
#                                                                                                                                #
#                                                                                                               ########         #
#                                                                                                                                #
#                                    ###########               #####                                                             #
#                                    #                                                                                           #
#    ##########################      #                                         ##################################                #
#                                    #                                         #                                                 #
#                                    #                                         #                                                 #
#                                    #          ##############                 #                                                 #
#                                 ####                                                                                           #
#                                    #                                                          #                                #
#                                    ######                                                    ###                               #
#                                    #                                                          #                                #
#                                                                                                                                #
#                                                                                                                 ################
#                                                                                ##########                                      #
#                                                                                                                                #
#                                                                                                                                #
#                                                                                                                                #
#                                                                                                                                #
##################################################################################################################################
##################################################################################################################################
##################################################################################################################################
