##################################################################################################################################
#                                                                                                                                #
#                                                                                                                                #
#                                                                                                                                #
#                                                                                                                                #
#                                                                                                                                #
#                                                                                                                                #
#                                                                                                                                #
#                                                                                                                                #
#                                                                                                                                #
#                                                                                                                                #
#                                                                                                                                #
#                                                                                                                                #
#                                                                                                                                #
#                                                                                                                                #
#                                                                                                                                #
#                                                                                                            #                   #
#                                                                                                                                #
#                                                                                                                                #
#                                                                                                         ##                     #
#                                                                                                       ##                       #
#                                                                                                         ##                     #
#                                                                                                       ##                       #
#                                           ############                                              ##                         #
#                                                                                                 ######                         #
#                                                                                                                                #
#                                                                                                                                #
#                                                                                                                                #
#                                                                                                                                #
#                                                                                                                                #
#                                                                                                                                #
#                                                                                                                                #
#                                                                                                                                #
#                                                                                                                                #
#                                                                                                                                #
#                                                                                                                                #
#                                                                                                                                #
#                                                                                                                                #
#                                                                                                                                #
#                                                                                                                                #
#                                                                                                                                #
#                                                                                                                                #
##################################################################################################################################
#                                                                                                                                #
#                                                                                                                                #
#                                                                                                                                #
#                                                                                                                                #
#                                                                                                                                #
#                                                                                                                                #
#                                                                                                                                #
#                                    #                                                                                           #
#                                    #                                                                                           #
#                                    #                                                                                           #
#                                    #                                                                                           #
#                                    #                                                                                           #
#                                    #                                                                                           #
#                                 ####                                                                                           #
#                                    #                                                                                           #
#                                    ######                                                                                      #
#                                    #                                                                                           #
#                                                                                                                                #
#                                                                                                                                #
#                                                                                                                                #
#                                                                                                                                #
#                                                                                                                                #
#                                                                                                                                #
#                                                                                                                                #
#                                                                                                                                #
#                                                                                                                                #
##################################################################################################################################
