#################################################################
#                                                               #
#                                                               #
#                                                               #
#                                                               #
#                                                               #
#                                                               #
#                                                               #
#                  #                                            #
#                  #                                            #
#                #####                                          #
#                  #                                            #
#                  #                                            #
#                                                               #
#                                                               #
#                                                               #
#                                                               #
#                                                               #
#                                                               #
#                                                               #
#                                                               #
#                                                               #
#                                                               #
#                                                               #
#                                                               #
#                                                               #
#                                                               #
#                                                               #
#                                                               #
#                                                               #
#                                                               #
#                                                               #
#                                                               #
#                                                               #
#################################################################