##################################################################################################################################
#                                                                                                                                #
#                                                                                                                                #
#                                                                                                                                #
#                                                                                                                                #
#                                                                                                                                #
#                                                                                                                                #
#                                                                                                                                #
#                                                                                                                                #
#                                                                                                                                #
#                                                       ##################                                                       #
#                                                       #                                                                        #
#                                                       #                                                                        #
#                                                       #                                                                        #
#                                                       #                                                                        #
#                                                       #                                                                        #
#                                                       #                                                    #                   #
#                                                       #                                                                        #
#                                                       #                                                                        #
#                                                       #                                                 ##                     #
#                                                       #                                               ##                       #
#                                                       #                                                 ##                     #
#                    #                                  #                                               ##                       #
#                    #                      #############                                             ##                         #
#                    #                                                                            ######                         #
#                    #                                                                                                           #
#                    #                                                                                                           #
#                                                                                                                                #
#                                                                                                                                #
#                                                                                                                                #
#                                                                                                                                #
#                                                                                          #                                     #
#                                                                                          #                                     #
#                                                                                          #                                     #
#                                                                                          #                                     #
#                                                                                          #                                     #
#                                                                                                                                #
#                                                                                                                                #
#                                                                                                                                #
#                                                                                                                                #
#                                                                                                                                #
#                                                                                                                                #
##################################################################################################################################
#                                                                                                                                #
#                                                                                                                                #
#                                                                                                                                #
#                                                                                                                                #
#                                                                                                                                #
#                                                                                                                                #
#                                                                                                                                #
#                                    #                                                                                           #
#                                    #                                                                                           #
#                                    #                                                                                           #
#                                    #                                                                                           #
#                                    #                                                                                           #
#                                    #                                                                                           #
#                                 ####                                                                                           #
#                                    #                                                          #                                #
#                                    ######                                                    ###                               #
#                                    #                                                          #                                #
#                                                                                                                                #
#                                                                                                                                #
#                                                                                                                                #
#                                                                                                                                #
#                                                                                                                                #
#                                                                                                                                #
#                                                                                                                                #
#                                                                                                                                #
#                                                                                                                                #
##################################################################################################################################
